2 13 31
6TTTTTTTTTTTTTTTTTTTTTTTTTTTTT7
LC * *2       *  ** * *      *R
L # # # #*# # #*# # # # # #*# R
L    * * *** **      *    **  R
L #*# # # # #1# #B#1# # # # #*R
L          *     **      *  **R
L # #*# # # # # #*#*#*#*# # # R
L   *        *   * *P* *      R
L # # # #*# # # # # # #*# #*# R
L   ****         *1           R
L # # # # # # # # #*# # # # #*R
L  ** *   *    2              R
9DDDDDDDDDDDDDDDDDDDDDDDDDDDDD8