4 13 31
6TTTTTTTTTTTTTTTTTTTTTTTTTTTTT7
LC    * **    *   3   4       R
L # # #*# # # # # # # # # # # R
L      ** * *  *   * ** 3 *   R
L # # # # #*# # # # # # #*# # R
L*   * *    *B* *   **        R
L # # # # # # # # # # # # #*# R
L    *     *        *    **  3R
L #*# # #*#*#*#*# # #1# # #*# R
L        * 4 *2*    *   *     R
L*# # # # # # # # # # #*# # #*R
LP*    * **    ** ***     1   R
9DDDDDDDDDDDDDDDDDDDDDDDDDDDDD8