1 13 31
6TTTTTTTTTTTTTTTTTTTTTTTTTTTTT7
LC     ** *    *   *  * * *   R
L # # #*# # #*#*# # # #*#*#*# R
L   *     ***  *      *   * * R
L # # # # #*# # #*#*# # # # #*R
LF         P **1 *  *  1     1R
L # # # # # # # # #*#1#*# # # R
L*  *      *  *      *        R
L # # # #*# # # #*#*# # # # # R
L*    **  *       *           R
L #*# # # # # # #*# # # # # # R
L           *1  *  *          R
9DDDDDDDDDDDDDDDDDDDDDDDDDDDDD8